GGGGGGGGGGGGGGGGGG
GGGGGGGGGGGGGGGGGG
GGGGGGGGGGGGGGGGGG
GGGGGFFFFFFFFFFGGG
GGGGGFRRRRRRRRFGGG
GGGGGFRRRRRRRRFGGG
GGGGGFRRRRRRRRFGGG
GGGGGFRRRRRRRRFGGG
GGGGGFRRRRRRRRFGGG
GGGGGFFFFFFFFFFGGG
GGGGGGGGGFFGGGGGGG
GGGGGGGGGGGGGGGGGG
GGGGGGGGGGGGGGGGGG
GGGGGGGGGGGGGGGGGG
GGGGGGGGGGGGGGGGGG
GGGGGGGGGGGGGGGGGG
GGGGGGGGGGGGGGGGGG
GGGGGGGGGGGGGGGGGG
GGGGGGGGGGGGGGGGGG