GGGGGGGGGGGGGGGGGGGG
GGGGGGGGGGGGGGGGGGGG
GGGGGGGGGGGGGGGGGGGG
GGGGGGFFFFFFFFFGGGGG
GGGGGGFFFFFFFFFGGGGG
GGGGGGFFFFFFFFFGGGGG
GGGGGGFFFFFFFFFGGGGG
GGGGGGFFFFFFFFFGGGGG
GGGGGGFFFFFFFFFGGGGG
GGGGGGFFFFFFFFFGGGGG
GGGGGGFFFFFFFFFGGGGG
GGGGGGFFFFFFFFFFGGGG
GGGGGGFFFFFFFFFFGGGG
GGGGGGGGGFFGGGGGGGGG
GGGGGGGGGGGGGGGGGGGG
GGGGGGGGGGGGGGGGGGGG
GGGGGGGGGGGGGGGGGGGG
GGGGGGGGGGGGGGGGGGGG
GGGGGGGGGGGGGGGGGGGG
GGGGGGGGGGGGGGGGGGGG