____________________
___WWWWWWWWWWWWWW___
________________W___
________________W___
___W____________W___
___W____________W___
___W____________W___
___WWWWWW__WWWWWW___
___W____________W___
___W__WWWWWWW__WW___
___W____________W___
___W____________W___
___W____________W___
___W________________
___W________________
___WWWWWWWWWWWWWW___
____________________
____________________
EOF
