____________________
_P_WWWWWWWWWWWWWW___
________________W___
_______________EW___
___W____________W___
___W_E__________W___
___W____________W___
___WWWWWW__WWWWWW___
___W____________W___
___W__WWWWWWW__WW___
___W____________W___
___W__E_________W___
___W________E___W___
___W________________
___W________________
___WWWWWWWWWWWWWW___
____________________
____________________
EOF
