____________________
_P_WWWWWWWWWWWWWW_P_
___D____________W___
___D___________EW___
___W____________W___
___W_E__________W___
___W____________W___
___WWWWWWDDWWWWWW___
___W____________W___
___WDDWWWWWWWDDWW___
___W____________W___
___W__E_________W___
___W________E___W___
___W____________D___
___W____________D___
___WWWWWWWWWWWWWW___
____________________
____________________
EOF
