GGGGGGGGGGGGGGGGGGGG
GGGGGGGGGGGGGGGGGGGG
GGGGGGGGGGGGGGGGGGGG
GGGGGGGGGGGGGGGGGGGG
GGGGGGFFFFFFFFFFFGGG
GGGGGGFFFGGGGGGGFFGG
GGGGGGFFFGGGGGGGGFGG
GGGGGGFFFGGGGGGGGFGG
GGGGGGFFFGGGGGGGGFGG
GGGGGGFFFGGGGGGGGFGG
GGGGGGFFFFGGGGGGGFGG
GGGGGGFFFFFFGGGGFFGG
GGGGGGGGGGGGGFFFFGGG
GGGGGGGGGGGGGGGGGGGG
GGGGGGGGGGGGGGGGGGGG
GGGGGGGGGGGGGGGGGGGG
GGGGGGGGGGGGGGGGGGGG
GGGGGGGGGGGGGGGGGGGG
GGGGGGGGGGGGGGGGGGGG