GGGGGGGGGGGGGGGGGGGG
GGGGGGGGGGGGGGGGGGGG
GGGFFFFFFGGGGGGGGGGG
GGGFFFFFFGGGGGGGGGGG
GGGFFRRFFGGGGGGGGGGG
GGGFFRRFFGGGGGGGGGGG
GGGFFRRFFGGGGGGGGGGG
GGGFFFFFFGGGGGGGGGGG
GGGFFFFFFGGGGGGGGGGG
GGGGGGGGGGGGGGGGGGGG
GGGGGGGGGGGGGGGGGGGG
GGGGGGGGGGGGGGGGGGGG
GGGGGGGGGGGGGGGGGGGG
GGGGGGGGGGGGGGGGGGGG
GGGGGGGGGGGGGGGGGGGG
GGGGGGGGGGGGGGGGGGGG
GGGGGGGGGGGGGGGGGGGG
GGGGGGGGGGGGGGGGGGGG
GGGGGGGGGGGGGGGGGGGG
GGGGGGGGGGGGGGGGGGGG