GGGGGGGGGGGGGGGGGGGG
GGGGGGGGGGGGGGGGGGGG
GGGGGGGGGGGGGGGGGGGG
GGGGGGGGGGGGGGGGGGGG
GGGGGGGGGGGGGFFGGGGG
GGGGGGGGGGGRRRRRRGGG
GGGGGGGGGGGRBBKKRGGG
GGGGGGGGGGGRBBKKRGGG
GGGGGGGGGGGRCCFFRGGG
GGGGGGGGGGGRCCFFRGGG
GGGGGGGGGGGRRRRRRGGG
GGGGGGGGGGGGGFFGGGGG
GGGGGGGGGGGGGCCGGGGG
GGGGGGGGGGGGGCCGGGGG
GGGGGGGGGGGGGCCGGGGG
GGGGGGGGGGGGGGGGGGGG
GGGGGGGGGGGGGGGGGGGG
GGGGGGGGGGGGGGGGGGGG
GGGGGGGGGGGGGGGGGGGG
GGGGGGGGGGGGGGGGGGGG