GGGGGGGGGGGGGGGGGGGG
GGGGGGGGGGGGGGGGGGGG
GGGGGGGGGGGGGGGGGGGG
GGGGGKKKKKFFFFFFGGGG
GGGGGKKKKKFFFFFFGGGG
GGGGGKKKKKGFFFFFGGGG
GGGGGKKKKKGFFFFFGGGG
GGGGGGGGGGGFFFFFGGGG
GGGGGFFFFFFFFFFFGGGG
GGGGGFRRRRRRRRRFGGGG
GGGGGFRRRRRRRRRFGGGG
GGGGGFRRRRRRRRRFGFFG
GGGGGFRRRRRRRRRFFFFG
GGGGGFFFFFFFFFFFFFFG
GGGGGGGGGGGGGGGGGFFG
GGGGGFFFFFFFFFFFFFFG
GGGGFFFFFFFFFFFFFFFG
GGGGGFFFFFFFFFFFGFFG
GGGGGGGGGGGGGGGGGGGG
GGGGGGGGGGGGGGGGGGGG